NO        assets/textures/parede2.xpm
SO assets/textures/parede2.xpm
WE assets/textures/paredes.xpm
EA assets/textures/paredes.xpm



F 050, 0, 0

C 100, 090 , 66



11111111111111111111111 111111111111111111111111111111111111        1111     11111
100011111111111111111101111   111111111111111111111111111111111111111111
10011111    11    1000001001                           110001111111
10001001111110111111110111111                           111111111011
100011111111111111111111111111111111111111111111111111111111111111111111111111111111111111       1     1                                  1111111111
110111111111111111111111111111111
1101111111111111111111111111111111111111111111111111111111111111111111111111111111111111111111111                                                              1
100011111111111111111111111111111111111111111111111111111111111111111111111111111111111111       1     1                                  1111111111
11011111
10W011111111111111111111111111111111111111111111111111111111111111111111111111111111111111       1     1                                  1111111111
11111111
                                                              1
                                                             1






                               
